deserve	 -할 만하다
poised	(~을 할)준비가 다 된
cart	(2륜)짐마차
he	(3인칭단수 남성)그
jet	(가스등의)분출
fright	(갑자기 엄습하는)공포
frustrate	(계획 등을)좌절시키다
blossom	(과수의)꽃
scrub	(관목의)숲
choir	(교회의)성가대
amount	(금액이)-이 되다
mechanism	(기계)장치
long	(길이,시간 등)긴
chip	(나무)토막
blink	(눈을)깜빡거리다
too	(-도)또한
chop	(도끼 등으로)자르다
pave	(도로를)포장하다
flavor	(독특한)맛
habitat	(동물의)자연번식지
neither	(둘중)어느쪽도 -아니다 -도 아니다
slip	(때가)어느덧 지나가다
paragraph	(문장의)절
compartment	(물건 보관용)칸
apply	(물건을)대다
pad	(및에)덧대는 것
embryo	(배아)태아
role	(배우의)역
from	(분리,이탈,출발점,기점)-로 부터
confide	(비밀을)털어놓다
peak	(뾰족한)끝
happen	(사건 등이)일어나다
blonde	(살결이 흰)금발의 여성
organ	(생물의)기관
format	(서적의)체제
laugh	(소리내어)웃다
manipulate	(손으로)다루다
meat	(식용짐승의)고기
column	(신문 등의)난
jar	(아가리가 넓은)항아리
undergo	(영향 등을)받다
fan	(영화 등의)팬
through	(-을)통하여 통하여 직통의
tend	(-의)경향이 있다
consensus	(의견 등의)일치
quit	(의무,책임을)벗어난 떠나다
oblige	(의무를)별수없이 -하게하다
mood	(일시적인)기분
resort	(자주)가다
knight	(중세의)기사
hat	(테있는)모자 모자를 씌우다
broad	(폭이)넓은
refugee	(피)난민
inclined	~경향이 있다.
concerning	~에 관하여
consequent	~의 결과로 일어나는
barring	~이 없다면, ~을 제외하고
prone	~하기 쉬운, ~경향이 있는
liable	~하기 쉬운, ~할 것 같은
enable	~할 수 있게 하다.
theater	극장
versus	…대, …에 대한
against	…에 반대하여
via	…을 거쳐, …을 경유하여
quarter	4분의 1
hundred	100
decade	10년간
teenage	10대
billion	10억
dozen	1다스
century	1세기
dose	1회복용량 투약하다
bilingual	2개 국어의
double	2배의
sophomore	2학년
may	5월  청춘, 인생의 봄  산사나무, 아가위나무
store	가게
cost	가격
furniture	가구
near	가까이 -의 가까이에 가까운 접근하다
occasional	가끔의
poverty	가난
poor	가난한 부족한, 불충분한, 빈약한
possibility	가능성
probable	가능성 높은
feasibility	가능성, 실행 가능함
possible	가능한
potential	가능한
go	가다
fill	가득 채우다
full	가득찬
sink	가라앉다
avenue	가로수길
rail	가로장
across	가로질러
powder	가루
teach	가르치다
instruct	가르치다
designate	가리키다
drought	가뭄
tap	가볍게 치기
hypothesis	가설
accelerate	가속하다 속도가 가해지다
petrol	가솔린
gasoline	가솔린
breast	가슴
chest	가슴팍
thorn	가시
sorry	가엾은
extra	가외의
scissors	가위
clip	가위로 자르다
border	가장자리
margin	가장자리
appliance	가전제품
home	가정
assumption	가정
tutor	가정교사
domestic	가정의
presume	가정하다
bring	가져오다
family	가족
household	가족
branch	가지
have	가지(고 있)다
various	가지가지의
arrange	가지런히 하다
value	가치
worth	가치가 있는 가치
worthwhile	가치있는
steep	가파른 -에 담그다 잠기다 담그기
angle	각
each	각각의
respective	각각의
triangle	각형
liver	간
interval	간격
interfere	간섭하다
hepatitis	간염
tickle	간지르다
appeal	간청하다
detect	간파하다
hook	갈고리
grind	갈다
gap	갈라진 틈
brown	갈색의 갈색
thirst	갈증
cheer	갈채
applaud	갈채를 보내다
sense	감각
sensation	감각
supervise	감독하다
admire	감복하다
gratitude	감사
thank	감사하다 감사
appreciate	감상하다
decrease	감소하다
diminish	감소하다
infect	감염시키다
potato	감자
emotion	감정
hide	감추다
abruptly	갑자기, 퉁명스럽게
deck	갑판
price	값, 가격, 대가, 정가
costly	값비싼
valuable	값비싼
cheap	값싼
baby	갓난아이, 막내   관심사, 골치아픈 일,
river	강
drastic	강력한, 과감함
intense	강렬한
precipitation	강수량
puppy	강아지
discourse	강연
rainfall	강우량
lecture	강의
press	강제로 모집하다
constrain	강제하다
emphasis	강조
emphasize	강조하다
highlight	강조하다
steel	강철
bang	강타
blow	강타
rob	강탈하다, 약탈하다, 빼앗다
strong	강한
intensify	강화하다
strengthen	강화하다
equate	같게하다
same	같은
equal	같은
together	같이
likewise	같이, 마찬가지로
dog	개
frog	개구리
concept	개념
ant	개미
improvement	개선
improve	개선하다
personality	개성
individual	개인
amendment	개정
reform	개정(개혁)하다
pioneer	개척자
session	개회
objective	객관적인
objectify	객관화하다
salon	객실
renew	갱신하다
there	거기에
adverse	거꾸로의
huge	거대한
enormous	거대한
gigantic	거대한
transaction	거래
street	거리
livingroom	거실
mirror	거울
almost	거의
scarcely	거의 ~않다.
hardly	거의 -아니다
seldom	거의-하지 않는
barely	거의-하지 않는, 간신히
giant	거인
refuse	거절하다
reject	거절하다
dwelling	거주, 거처
resident	거주자
dwell	거주하다
reside	거주하다
false	거짓
harsh	거친
rough	거친
foam	거품
bubble	거품 거품이 일다
care	걱정
anxious	걱정되는
worrisome	걱정스러운
health	건강
checkup	건강검진
construct	건조하다
hay	건초더미
architecture	건축
architect	건축가
step	걷다
walk	걷다
kick	걷어차다
bet	걸다
hang	걸다
masterpiece	걸작
inspect	검사하다
censor	검열관
black	검은
terrify	겁나게 하다
shell	겉껍질
seemingly	겉보기에
besides	게다가,~외에
lazy	게으른
neglect	게을리 하다
aim	겨누다
contest	겨루다
rage	격노
shock	격돌
violent	격렬한, 맹렬한
combat	격투하다
nut	견과
endure	견디다
containment	견제, 억제
effect	결과
result	결과
outcome	결과
consequence	결과
eventually	결국
conclusion	결론
bond	결속
deficit	결손
goal	결승점
fault	결점
defect	결점
decision	결정
crucial	결정적인
decide	결정하다
conclude	결정하다
determine	결정하다
never	결코 -아니다
lack	결핍
want	결핍
deficiency	결핍
defective	결함이 있는
union	결합
fusion	결합
join	결합하다
unite	결합하다
combine	결합하다
marry	결혼하다
humble	겸손한
modest	겸손한
overlap	겹치다
boundary	경계
warn	경고하다
career	경력
auction	경매
guard	경비원, 지키다
case	경우
occasion	경우
marvel	경이
wonder	경이
cultivate	경작하다
rival	경쟁자 경쟁하는 경쟁하다
compete	경쟁하다
police	경찰 경비하다
listen	경청하다
celebrate	경축하다
scenery	경치
inclination	경향, 기울어짐
experience	경험
suffer	경험하다
by	곁에
aside	곁에
class	계급
stairs	계단
terrace	계단모양의 뜰(광장)
count	계산
bill	계산서
counter	계산하는 사람
calculate	계산하다
continuous	계속되는
continual	계속적인
keep	계속하다
last	계속하다
continue	계속하다
maintain	계속하다
contract	계약
season	계절
hierarchy	계층, 계급
plan	계획
scheme	계획
customer	고객
archaeologist	고고학자
noble	고귀한
altitude	고도
solitary	고독을 즐기는
whale	고래
choose	고르다
select	고르다
ring	고리
isolation	고립, 고독
isolate	고립시키다
grateful	고맙게 생각하는
torture	고문
accuse	고발하다
trouble	고생
adhere	고수하다
device	고안
devise	고안하다
improvise	고안하다
cat	고양이
hire	고용하다
employ	고용하다
proper	고유의, 독특한, 본연의,  특유한
classic	고전의
fixture	고정 세간, 붙박이
fix	고정시키다
bore	고조
persist	고집하다
solid	고체의
pepper	고추
heal	고치다
rectify	고치다, 바로잡다
ache	고통
pain	고통
tackle	고패
yell	고함치다
tune	곡
grain	곡물
curve	곡선
hardship	곤란
difficult	곤란한
insect	곤충
straight	곧은
antique	골동품
alley	골목길
valley	골짜기
curl	곱슬머리 머리털을 지지다
ball	공
space	공간
forum	공개토론회
aggression	공격,침략
attack	공격하다
supply	공급하다
furnish	공급하다
air	공기
community	공동생활체
collaborate	공동으로 일하다
elaborate	공들인
ideology	공리
global	공모양의
officer	공무원
official	공무원
blank	공백
communist	공산주의자
fancy	공상
polite	공손한
formula	공식
industry	공업
park	공원
factory	공장
fair	공평한
horror	공포
airport	공항
republic	공화국
cape	곶
past	과거
pastime	과거
target	과녁
curriculum	과목
extracurricular	과외의, 정규 과목 이외의
fruit	과일
exaggerated	과장된
exaggerate	과장하다
assignment	과제, 할당
overweight	과체중의
science	과학
tube	관
irrigation	관개
regardless	관계없이
concern	관계하다
tourism	관광 사업
attraction	관광명소
idea	관념
relevant	관련된
convention	관례
manage	관리하다
administer	관리하다
shrub	관목
temple	관자놀이
viewpoint	관점
aspect	관점, 면, 측면
observe	관찰하다
locate	관청 등을 두다
pierce	관통하다
orchestra	관현악단
sight	광경
spectacle	광경
advertise	광고하다
generous	광대한
extensive	광대한
vast	광대한, 광막한 막대한
mineral	광물
extensively	광범위하게
mine	광산, 채굴하다
miner	광산업자
beam	광선
tease	괴롭히다
bother	괴롭히다 근심하다 귀찮음
monster	괴물
boom	굉음
textbook	교과서
jail	교도소
prison	교도소
disturb	교란하다
negotiate	교섭하다
professor	교수
classroom	교실
suburb	교외
outskirt	교외, 변두리
education	교육
educate	교육하다
revise	교정하다
company	교제
intersection	교차로(점)
traffic	교통
symphony	교향곡
exchange	교환하다
cunning	교활한
fox	교활한 사람
church	교회
phrase	구
sphere	구
premises	구내, 건물(내)
shoe	구두
oral	구두의
roll	구르다
cloud	구름
cooper	구리
hole	구멍
distinguish	구별하다.
distinctively	구별하여, 특징적으로
flexible	구부리기 쉬운
bend	구부리다
component	구성하는 성분
compose	구성하다
constitute	구성하다
salvation	구원,구제
frame	구조
structure	구조
concrete	구체적인 응고물
relieve	구출하다
rescue	구하다
chant	구호(성가)
nation	국가
confine	국경
phase	국면
premier	국무 총리, 수상
international	국제적인
military	군의
soldier	군인
crowd	군중
firm	굳은
stiff	굳은
tumble	굴러 떨어지다
starve	굶어 죽다
hunger	굶주림
bake	굽다
palace	궁전
authority	권위, 정부 당국
offer	권하다
cigarette	궐련
bin	궤
orbit	궤도
ear	귀
lady	귀부인
cute	귀여운
darling	귀여운
tattoo	귀영나팔
annoy	귀찮게하다
regulate	규정하다
stipulate	규정하다
rule	규칙
regular	규칙적인
rally	규합하다
balance	균형
instead	그 대신에
else	그 밖에
moreover	그 위에
it	그것은
she	그녀는
shade	그늘
meanwhile	그동안
meantime	그동안 그 사이에
they	그들
then	그때
but	그러나 다만 (-을)제외하고
gather	그러모으다
hence	그러므로
therefore	그런 까닭에
nevertheless	그럼에도 불구하고
graphic	그려 놓은 듯한
band	그룹
vessel	그릇
picture	그림
shadow	그림자
cease	그만두다 그치다 중지
net	그물
network	그물세공
so	그와 같이
extreme	극단의
dramatic	극적인, 연극의
microwave	극초단파 전자레인지로 요리하다
diligent	근면한
radical	근본적인, 급진적인
anxiety	근심
worry	근심하다
muscle	근육
proximity	근접
flaw	금
gold	금
metal	금속
money	금전
ban	금지
forbid	금하다
inhibit	금하다
prohibit	금하다, 금지하다
haste	급함
flag	기
term	기간
machine	기계
mechanical	기계의
balloon	기구
implement	기구
instrument	기구
famine	기근
fund	기금
willing	기꺼이 하는
willingly	기꺼이, 자진해서
memorial	기념비
monument	기념비
anniversary	기념일 예년의
souvenir	기념품
agency	기능
function	기능
creep	기다
scramble	기다
wait	기다리다
await	기다리다
expectation	기대
lean	기대다
expect	기대하다
post	기둥
workmanship	기량, 솜씨
note	기록
register	기록
archive	기록보관소
record	기록하다
breed	기르다
foster	기르다
oil	기름
fry	기름으로 튀기다
giraffe	기린
confidentiality	기밀성
basic	기본의
elementary	기본의
contribute	기부하다
pleasant	기분 좋은
please	기쁘게 하다
glad	기쁜
bliss	기쁨
engineer	기사
meteorological	기상의
dormitory	기숙사
describe	기술하다
climb	기어 오르다
memory	기억
remember	기억하고 있다
entrepreneurship	기업가 정신
decline	기울다
tilt	기울이다
incline	기울이다
origin	기원
miracle	기적
stun	기절시키다
faint	기절하다
criterion	기준
endowment	기증, 기부
wit	기지
temper	기질
train	기차
base	기초
basis	기초
basement	기초
foundation	기초
fundamental	기초(기준)의
cough	기침 기침을 하다 기침을 하여 -을 뱉어내다
geometry	기하학
opportunity	기회
enterprise	기획
climate	기후
urgent	긴급한
tension	긴장
way	길
road	길
route	길
patch	깁는 헝겊
feather	깃털
plume	깃털장식
deep	깊은
profound	깊은, 심원한
till	-까지
until	-까지
shave	깎다
sheet	깔천
amaze	깜짝 놀라게 하다
startle	깜짝놀라게 하다
remark	깨닫다
realise	깨닫다
realize	깨닫다
fragile	깨어지기 쉬운
awake	깨우다
awaken	깨우다
extinct	꺼진
peel	껍질을 벗기다 벗어지다 껍질
leap	껑충 뛰다
tail	꼬리
twist	꼬이다
pinch	꼬집다
hug	꼭 껴안다
summit	꼭대기
bound	꼭-해야 할, 뛰어오르다
meticulously	꼼꼼하게
flower	꽃
slam	꽝하는 소리
induce	꾀다
pack	꾸러미
scold	꾸짖다 잔소리 심한 사람
bee	꿀벌
dream	꿈
sew	꿰매다
nod	끄덕이다
string	끈
persistence	끈덕짐, 고집
drag	끌다
pull	끌다, 당기다, 끌어 당기다, 잡아 끌다
attract	끌어 당기다
lift	끌어올리다
boil	끓다
end	끝
tip	끝
finish	끝내다
terminate	끝내다
edge	끝머리
insert	끼워넣다
divide	나누다
I	나는, 내가
country	나라
ferry	나루터
bear	나르다
carry	나르다
convey	나르다
tree	나무
condemn	나무라다
stick	나무토막
bad	나쁜
wrong	나쁜
screw	나사
advance	나아가다
proceed	나아가다, 가다
emerge	나오다
elderly	나이가 지긋한
knife	나이프
appear	나타나다
reveal	나타내다
disclose	나타내다
optimistic	낙관적인
dairy	낙농장
dismay	낙담시키다
discourage	낙담시키다, 단념시키다
paradise	낙원
optimist	낙천가
disorder	난잡
embarrass	난처하게 하다
wreck	난파
stack	낟가리
wing	날개
raw	날것의
flight	날기
fly	날다
weather	날씨
date	날짜
keen	날카로운
acute	날카로운
sharp	날카로운
polar	남극의
leave	남기고가다
remain	남다
pan	남비 사금 등을 남비로 가려내다
male	남성의
abuse	남용
leftover	남은 음식
privacy	남의 눈을 피함, 은거, 은둔, 은퇴 생활 사생활
man	남자
south	남쪽 남쪽의 남으로
husband	남편 절약하다
extravagant	낭비벽이 있는
waste	낭비하다
day	낮
low	낮은
nap	낮잠
word	낱말
generate	낳다
overlook	내려다 보다
descend	내려오다
dump	내버리다
internal	내부의
tomorrow	내일(은)
expel	내쫒다
contain	내포하다
smell	냄새
cynical	냉소적인
fridge	냉장고
refrigerator	냉장고
legnthy	너무 긴, 장황한
widespread	널리 보급되어 있는
board	널빤지
spacious	넓은
extent	넓이
surrender	넘겨주다
exceed	넘다
overflow	넘쳐흐르다
crawl	네발로 기다
guy	녀석
labor	노동
labour	노동
workforce	노동력
song	노래
sing	노래하다
effort	노력
strive	노력하다
veteran	노련가, 경험 많은 대가, 베테랑
slave	노예 노예처럼 일하다
irritate	노하게 하다
furious	노하여 펄펄뛰는
melt	녹다
controversial	논란의
logic	논리학
controversy	논쟁
dispute	논쟁하다
theme	논제
comment	논평
argue	논하다
play	놀다
alarm	놀라게 하다
astonish	놀라게 하다
surprise	놀람
basketball	농구
joke	농담
peasant	농부
agriculture	농업
farm	농장
high	높은
height	높이
put	놓다, 두다
brain	뇌
who	누구
eye	눈
snow	눈 눈이 내리다
blind	눈먼
tear	눈물
frown	눈살을 찌푸리다
eyebrow	눈썹
striking	눈에 띄는
conspicuous	눈에 띄는
outstanding	눈에 띄는
noticeable	눈에 띄는, 현저한
visible	눈에 보이는,  볼 수 있는
crush	눌러 부수다
lie	눕다
lay	눕히다
slow	느린
always	늘
increase	늘다
obsess	늘러붙다
multiply	늘리다
prolong	늘리다, 연장하다
old	늙은
faculty	능력
competent	능력있는
efficient	능률적인
proficient	능숙한
late	늦은
delay	늦추다
relax	늦추다
nice	니스(프랑스 남부의 항구도시)
numerous	다 수의, 수많은, 셀 수 없이 많은
exhaust	다 써버리다
approach	다가가다
forthcoming	다가오는
attic	다락
differ	다르다.
different	다른
other	다른 다른 것 그렇지 않고
distinct	다른, 뚜렷한
leg	다리
bridge	다리
alone	다만 홀로(혼자서)
bundle	다발
packet	다발
govern	다스리다
again	다시
resume	다시 잡다
variety	다양성
diverse	다양한
versatile	다용도의
next	다음의
subsequent	다음의, 그후의
perform	다하다
random	닥치는 대로의
wipe	닦다
polish	닦다, 갈다, 윤내다
sweet	단
platform	단
single	단 하나의
patronize	단골로 삼다
college	단과대학
hard	단단한
tight	단단한
tough	단단한
fasten	단단히 고정시키다
clue	단서
mere	단순한
brief	단시간의
assert	단언하다
protest	단언하다
unit	단위
simple	단일의
monotonous	단조로운
pot	단지
merely	단지
button	단추 단추를 채우다 단추로 채워지다
determined	단호한, 단단히 결심한
shut	닫다
close	닫다
moon	달
calendar	달력
run	달리다
flee	달아나다
lunar	달의
resemble	닮다
dip	담그다
soak	담그다
tobacco	담배
blanket	담요
carrot	당근
draw	당기다
diabetes	당뇨병
you	당신
puzzle	당황, 혼란 괴롭히는 사람,  어려운 문제
bewilder	당황하게 하다
anchor	닻
touch	닿다
troop	대
expertise	대가의 의견
atmosphere	대기
majority	대다수
immensely	대단히, 엄청나게
bold	대담한
answer	대답
reply	대답하다
respond	대답하다
highway	대도
approximately	대략
agent	대리인
bald	대머리의
spokesperson	대변인
loan	대부
ambassador	대사
embassy	대사관
cathedral	대성당
for	대신에
basin	대야,접시
ocean	대양
substitute	대용하다 대신하다 대리(인)
treat	대우하다
contrast	대조
president	대통령 회장
representative	대표자, 대표하는
dialogue	대화
converse	대화하다
dance	댄스
dam	댐
dirty	더러운
stain	더럽히다
furthermore	더우기
plus	더하기의 -외에
alright	더할나위없이
virtue	덕, 덕행, 선, 선행
cast	던지다
toss	던지다
pitch	던지다
throw	던지다
bush	덤불
snap	덥석 물다
lump	덩어리
mass	덩어리
block	덩어리
trap	덫
cover	덮다
obscure	덮어 감추다
database	데이터베이스
degree	도
also	-도 또한
nor	-도 또한-않다
pottery	도기
ethical	도덕상의
moral	도덕의
thief	도둑
paint	도료
escape	도망하다
wholesale	도매의
gamble	도박하다 도박 도박해서 잃다
crash	도산
slaughter	도살
library	도서관
city	도시
urban	도시의
skip	도약
ceramic	도예,도자기
aid	도와 주다
release	도와주다
introduction	도입
stamp	도장
challenge	도전
reach	도착하다
arrive	도착하다
poison	독
independent	독립한
toxic	독의
solo	독주
stone	돌
dolphin	돌고래
turn	돌리다
return	돌아가다
panic	돌연한공포
dash	돌진
rush	돌진하다
blast	돌풍
help	돕다
assist	돕다
coordinate	동격의
cave	동굴 굴을 파다 꺼지다
motive	동기
motivate	동기를 부여하다.
peer	동료
colleague	동료
companion	동료
co-worker	동료
ally	동맹하다
fellow	동무
animal	동물
zoo	동물원
accompany	동반하다
simultaneous	동시에 일어나는(존재하는)
while	동안 -하는 동안
during	-동안에
orient	동양 동양의 동쪽으로 향하게 하다
agree	동의하다
identify	동일시하다
dynamic	동적인
sympathy	동정
compassion	동정
east	동쪽 동쪽의 동쪽으로
sail	돛
canvas	돛베
pig	돼지
pork	돼지고기
replace	되돌려 놓다
recall	되부르다
recover	되찾다
twice	두 번
twofold	두 부분의
pound	두근거리다
thick	두꺼운
markedly	두드러지게
prominet	두드러진
prominent	두드러진, 돌기한, 양각된 현저한, 탁월한, 중요한
awful	두려운
fearful	두려운
fear	두려움
dread	두려워하다 두려움
afraid	두려워하여
boss	두목
headache	두통
bank	둑
dull	둔한
survey	둘러보다
perimeter	둘레
dual	둘의
round	둥근 원 돌아서
rear	뒤
boost	뒤를 밀기
behind	뒤에
upset	뒤집어 엎다
latter	뒤쪽의
score	득점
hear	듣다
field	들
enter	들어가다
entry	들어감
back	등
lamp	등
grade	등급
etc	등등
enrollment	등록
settle	등받이가 높은 긴 의자 놓다
design	디자인
pick	따다
warm	따뜻한
accordingly	따라서
reserve	따로 두다
obey	따르다
pour	따르다
otherwise	딴 방법으로는
daughter	딸
strawberry	딸기
sweat	땀
ground	땅
time	때
belated	때늦은
dismiss	떠나게 하다
drift	떠돌다
undertake	떠맡다
sustain	떠받치다
tremble	떨다
off	떨어져
away	떨어져서
apart	떨어져서
fall	떨어지다
distant	떨어진
cluster	떼
raft	뗏목
another	또 하나
erect	똑바로 선
lid	뚜껑
hop	뛰다
excel	뛰어나다
superior	뛰어난
dive	뛰어들다
plunge	뛰어들다, 빠지다
bounce	뛰어오르다
hot	뜨거운
float	뜨다
garden	뜰
accident	뜻밖의 사건
label	라벨
to	-로
pope	로마 교황  최고 권위자로 자처하는 사람
harness	마구
sack	마대
floor	마룻바닥
dry	마른
paralyze	마비시키다
drink	마시다
village	마을, 촌락
mind	마음
favorite	마음에 드는 좋아하는 물건
mental	마음의
reluctant	마음이 내키지 않는
rub	마찰하다
hinder	막다, 방해하다
prevent	막다, 방해하다
rod	막대
bar	막대기
vague	막연한
bay	만
gulf	만
make	만들다
institute	만들다
chronic	만성의
if	만일 -이라면
contingency	만일의 사태
feel	만져보다
satisfy	만족시키다
content	만족하여
many	많은
much	많은
plenty	많음
horse	말
verbalize	말로 나타내다
tidy	말쑥한
involve	말아넣다
address	말을 걸다
linguistic	말의
verbal	말의, 말에 관한, 언어상의, 말로 나타낸, 말로 된
say	말하다
talk	말하다
tell	말하다
mention	말하다
clear	맑은
taste	맛
rubber	맛사지사
delicious	맛있는
telescope	망원경
spoil	망쳐놓다
hammer	망치
fit	맞는
adjust	맞추다
assume	맡다, 취하다
smooth	매끄러운
tie	매다
bind	매다
suspend	매달다
knot	매듭(=tie)
charm	매력
landfill	매립지
trade	매매
bargain	매매
very	매우
beloved	매우 사랑하는
priceless	매우귀중한
pulse	맥박
beer	맥주
vow	맹세
swear	맹세하다
head	머리
duck	머리를 물 속에 쑥 쳐박다
overhead	머리위에 머리 위의
headline	머릿기사,표제
stay	머무르다
eat	먹다
prey	먹이
remote	먼
faraway	먼
dust	먼지
dirt	먼지, 때
far	멀리
stop	멈추다
halt	멈춰서다
dumb	멍청한,벙어리의
echo	메아리
mill	멧돌
immune	면역성의
area	면적
waive	면제하다, 포기하다
rid	면하게하다
licence	면허
license	면허
extinction	멸종
extinctions	멸종
command	명령하다
mandate	명령하다, 요구하다
prescribe	명령하다, 지령하다
evident	명백한
obvious	명백한
apparent	명백한
explicit	명백한
manifest	명백히 하다
enrol	명부에 올리다
enroll	명부에 올리다
meditation	명상
fame	명성
celebrity	명성
specify	명시하다
honor	명예
honour	명예
hit	명중하다
positive	명확한, 의문의 여지가 없는, 부정할 수 없는
all	모든
every	모든
sand	모래사장
pattern	모범
contradiction	모순, 반박
figure	모습
form	모양
shape	모양
insult	모욕하다
collect	모으다
assemble	모으다
cap	모자
fake	모조품
corner	모퉁이
fur	모피
venture	모험
adventure	모험 모험하다
vaguely	모호하게, 막연히
neck	목
throat	목
cowboy	목동
vocal	목소리
voice	목소리, 음성, 음성
bath	목욕
boot	목이 긴 구두
ranch	목장
lumber	목재
purpose	목적
destination	목적지
cotton	목화
share	몫
sneak	몰래 움직이다
urge	몰아대다
gesture	몸짓
pond	못, 연못
depict	묘사하다
cemetery	묘지
odd	묘한
heavy	무거운
weight	무게
weigh	무게를 달다
indifferent	무관심한
innocent	무구한
weapon	무기
stage	무대
grave	무덤
leather	무두질한 가죽
insolent	무례한
discourteous	무례한
complimentary	무료의, 칭찬하는
lap	무릎
knee	무릎
kneel	무릎을 꿇다
flock	무리
herd	무리. 떼
awesome	무서운
terrific	무서운
tremendous	무서운
frighten	무섭게 하다.
horrible	무시무시한
terrible	무시무시한
ignore	무시하다
what	무엇 무슨
no	무의
weightlessness	무중력
ignorance	무지
rainbow	무지개
immense	무한한
infinite	무한한
intangible	무형의
door	문
gate	문
context	문맥
civilization	문명
literal	문자의
sentence	문장
problem	문제
issue	문제[쟁점]/호/발행/발표하다
literature	문학
literary	문학의
culture	문화
ask	묻다
bury	묻다
enquire	묻다
inquire	묻다
water	물
shore	물가
thing	물건
wave	물결
fish	물고기
bite	물다
dye	물들이다
withdraw	물러나다
physics	물리학
drip	물방울을 떨어뜨리다
drown	물에빠뜨리다
question	물음, 질문, 질의
sophisticated	물정에 닳고 닳은
matter	물질
substance	물질
physical	물질의
article	물품
land	뭍
slide	미끄러지다
future	미래
widow	미망인
subtle	미묘한
delicate	미묘한
missile	미사일
smile	미소짓다 미소
superstition	미신
hate	미워하다
mummy	미이라
aesthetic	미적인
mad	미친
crazy	미친
breeze	미풍
miss	미혼 여성 실수하다
sensitive	민감한
democracy	민주주의
democrat	민주주의자
popular	민중 의, 대중의
rely	믿다
believe	믿다
incredible	믿을 수 없는
credible	믿을 수 있는
belief	믿음, 신념
wheat	밀
push	밀다, 밀치다, 밀어서 움직 이다, 밀어 내다
implication	밀접한 관계, 관련, 암시
cling	밀착하다
and	및
bottom	밑바닥
undermine	-밑을 파다
basket	바구니
vary	바꾸다
alter	바꾸다
convert	바꾸다
displace	바꾸어놓다
needle	바늘 바늘로 꿰매다 바느질하다 아슬아슬한
sea	바다
marine	바다의
wish	바라다
desire	바라다
wind	바람
desirable	바람직한
fade	바래다
fool	바보
busy	바쁜
rock	바위
pants	바지
glitter	바짝이다
devote	바치다
wheel	바퀴
museum	박물관
doctor	박사
smash	박살내다
out	밖으로
half	반
contrary	반대의 반대 거꾸로
hostile	반대하는
oppose	반대하다
peninsular	반도
imperative	반드시 해야 하는
contradict	반박하다
repeat	반복하다
reflect	반사하다
irony	반어
ironic	반어적인
rebel	반역자
react	반응을 나타내다
sparkle	반짝이다
restore	반환하다
receive	받다
admit	받아들이다
grant	받아들이다
accept	받아들이다
dictate	받아쓰게 하다
reception	받음
foot	발
toe	발가락
naked	발가벗은
discovery	발견
find	발견하다
discover	발견하다
develop	발달하다
heel	발뒤꿈치
vivid	발랄한, 약동적인, 힘찬, 생기있는
invent	발명하다
ankle	발목
incidence	발생정도, 범위
pronounce	발음하다, 음독하다
trace	발자국
publish	발표 하다, 널리 알리다
express	발표하다
fermentation	발효
bright	밝은
uncover	밝히다
night	밤
cord	밧줄
room	방
chamber	방
vastly	방대하게, 대단히
visit	방문하다, …의 손님으로 묵다
mode	방법
manner	방법
method	방법
emit	방사하다
broadcast	방송하다
trigger	방아쇠 재빠른
defence	방어
defense	방어
defend	방어하다
drop	방울
shield	방패
check	방해
obstruct	방해하다
trend	방향
boat	배
ship	배
background	배경
hungry	배고픈
aboard	배로
betray	배반하다
compensate	배상하다
endorsement	배서, 보증
drain	배수하다
jury	배심
dispose	배열하다
learn	배우다
spouse	배우자
exclude	배척하다
emission	배출
outlet	배출구
exclusively	배타적으로
exclusive	배타적인
bat	배트
encyclopedia	백과사전
million	백만
millionaire	백만장자
daydream	백일몽
snake	뱀
struggle	버둥거리다
rude	버릇없는
desert	버리다
abandon	버리다
discard	버리다
mushroom	버섯
version	번역, 번역문 개작, 각색, 번안
translate	번역하다
prosperous	번영하는, 번창한
prosper	번영하다
glare	번쩍이는 빛
flash	번쩍임
flourish	번창하다
penalty	벌
bare	벌거벗은
honey	벌꿀
bug	벌레
punish	벌하다, 응징하다, 처형하다
scope	범위
crime	범죄
category	범주
perpetrate	범하다, 저지르다
law	법률
lawyer	법률가
legal	법률상의
legislate	법률을 제정하다
corporate	법인조직의
code	법전
court	법정, 경기장
strip	벗기다
cut	베다
wall	벽
brick	벽돌
closet	벽장
mural	벽화
modify	변경하다
fluctuation	변동
excuse	변명
reimburse	변상하다, 환급하다
disguise	변장하다
transition	변천
variable	변하기 쉬운
transform	변형(변용,변태)시키다
attoney	변호사
advocate	변호사
attorney	변호사
change	변화
sudden	별안간의
bottle	병
disease	병
sickness	병
sick	병난
ill	병든
warrior	병사
clinic	병원
hospital	병원
screen	병풍
reinforce	보강하다
report	보고
nest	보금자리
example	보기
extrairdinary	보기 드문, 탁월한
send	보내다
transmit	보내다
see	보다
look	보다
outpace	보다 속도가 빠르다
above	-보다 위에
than	-보다도
coverage	보도,보상,적용범위
treasure	보물
compensation	보상
reward	보수
complement	보완하는 것
retain	보유하다
show	보이다
display	보이다
exhibit	보이다
conserve	보존하다
insure	보증하다
guarantee	보증하다
warrant	보증하다 보증
assure	보증하다, 안심시키다
ordinary	보통의
pedestrian	보행자
insurance	보험, 보장
custody	보호
protection	보호
guardian	보호자
protect	보호하다, 막다, 지키다, 비호하다
preserve	보호하다, 지키다
lottery	복권
corridor	복도
duplicate	복사하다
revenge	복수
gospel	복음서, 신조
complicate	복잡하게 하다
complicated	복잡한
costume	복장
submit	복종시키다
subject	복종시키다
multiple	복합의
instinct	본능
headquarters	본부
essentially	본질적으로
essential	본질적인
cheek	볼
hostage	볼모
view	봄, 관찰, 개관, 실지 검증  보는 힘, 시계, 시야
salary	봉급 봉급을 주다
dedicate	봉납하다
envelope	봉투
department	부
impose	부과하다
ashamed	부끄러운
shame	부끄럼
soft	부드러운
envious	부러워하는
supplement	부록
call	부르다
parental	부모의
counterpart	부본
part	부분
section	부분
partial	부분적인
wound	부상
accessory	부속물
break	부수다
kitchen	부엌
enrich	부유하게하다
wealthy	부유한
woman	부인
rich	부자인
absence	부재
absent	부재의
negative	부정적인
deny	부정하다
scarcity	부족
shortage	부족
scarce	부족한
meager	부족한, 결핍된
negligence	부주의, 태만
careless	부주의한
site	부지
sector	부채꼴
instigate	부추기다, 선동하다
request	부탁하다
inflate	부풀게 하다
swell	부풀다
bulk	부피
sign	부호
hatch	부화하다
north	북, 북 쪽, 북부
minute	분
diverge	분기하다, 나눠지다
resentful	분노한
classify	분류하다
separate	분리된
detach	분리하다
plain	분명한
clarify	분명히 하다, 맑게 하다
distribute	분배하다
sensible	분별있는
discriminate	분별하다
fraction	분수
disrupt	분열시키다
molecule	분자
erupt	분출하다
division	분할, 부서
analyse	분해하다
resolve	분해하다
fire	불
mystery	불가사의
weird	불가사의한
disabled	불구가 된
flame	불꽃
spark	불꽃
disadvantage	불리
handicap	불리한 조건
disgrace	불명예
outrage	불법(적인 행위)
outlaw	불법화하다
constant	불변의
pity	불쌍히 여김
roast	불에 쬐어 굽다 불고기 구운
disgust	불쾌하게 하다
nasty	불쾌한
complain	불평하다
absurd	불합리한
red	붉은
collapse	붕괴
breakdown	붕괴
attach	붙이다
catch	붙잡다
grasp	붙잡다
seize	붙잡다
capture	붙잡다(=catch)
grab	붙잡다(=snatch)
brake	브레이크
rain	비
informal	비공식의
pessimistic	비관적인
compare	비교하다
tragic	비극의
soap	비누 비누로 씻다
scale	비늘(모양의 것)
silk	비단
although	비록 -일지라도
originate	비롯되다, 유래하다
scream	비명을 지르다
secret	비밀의
emergency	비상사태
secretary	비서
alike	비슷한
precious	비싼
fertile	비옥한
expensive	비용이 드는
evacuate	비우다
ridicule	비웃다
proportion	비율, 비 균형, 조화
abnormal	비정상적인
miserable	비참한
slope	비탈
sorrowful	비통한
stumble	비틀거리다
skeptical	비판적인
criticism	비평
critic	비평가
criticise	비평하다
criticize	비평하다
airplane	비행기
empty	빈
lounge	빈둥거리다
frequent	빈번한
alert	빈틈없는
pray	빌다
borrow	빌다
lend	빌리다
iceberg	빙산
glacier	빙하
debt	빚
light	빛
brilliant	빛나는
shine	빛나다
fast	빠른
quick	빠른
rapid	빠른
swift	빠른
suck	빨다
tug	빨리 끌어당기다
bread	빵
deprive	빼앗다
extend	뻗다
stretch	뻗치다
bone	뼈
framework	뼈대
proud	뽐내는, 자랑하는 자긍하는, 영광 으로 여기는
extract	뽑아내다
root	뿌리
horn	뿔
scatter	뿔뿔이 흩어 버리다
sprain	삐다
incident	사건
apple	사과
apology	사과
apologize	사과하다
sociable	사교적인
fraud	사기
morale	사기
hunt	사냥하다
buy	사다
purchase	사다, 구입하다
ladder	사닥다리
person	사람
folk	사람들
people	사람들
love	사랑
thoughtful	사려 깊은, 배려하는
mission	사명
object	사물
bowl	사발
around	사방에
judicial	사법의
copy	사본
editorial	사설
trivial	사소한
trivia	사소한 일
chain	사슬
link	사슬의 고리
fact	사실
virtual	사실상의, 실질상의, 실제의  허상의
evil	사악한
wicked	사악한
usage	사용법, 용례
tool	사용세
intervene	사이에 들다
sin	사인
resign	사임하다
lion	사자
private	사적인, 사사로운, 개인에 속한
dictionary	사전
photograph	사진 촬영하다
photography	사진술
cousin	사촌
luxury	사치
luxurious	사치스러운
candy	사탕과자
dialect	사투리
society	사회
social	사회의
sociology	사회학
delete	삭제하다
mount	산
mountain	산
acid	산 신
neat	산뜻한
trim	산뜻한 정돈하다
shatter	산산히 부서지다
oxygen	산소
output	산출
yield	산출하다
flesh	살
live	살다
inhabit	살다
survive	살아 남다
alive	살아있는
murder	살인
jog	살짝 밀다 덜커덕 움직이다 고르지 않음
fat	살찐
ounce	삵괭이
swallow	삼키다
episode	삽화
award	상
prize	상, 포상, 우등상, 선행상
considerable	상당한
mate	상대
opponent	상대, 반대자
imagination	상상
imagine	상상하다
suppose	상상하다
conceive	상상하다
detail	상설
heir	상속인
inherit	상속하다
commerce	상업
commercial	상업의, 광고방송
consult	상의하다
merchant	상인
shop	상점
symbol	상징
symbolize	상징하다
hurt	상처내다
state	상태
brand	상표
goods	상품
commodity	상품
merchandise	상품
mutual	상호의
mutural	상호의
bird	새
rope	새끼
new	새로운
fresh	새로운
innovate	새롭게 하다
update	새롭게 하다 최신정보
dawn	새벽 날이 새다
mouse	새앙쥐
cage	새장
index	색인
leak	샘
fountain	샘
remind	생각나게 하다
think	생각하다
arise	생기다
omission	생략
omit	생략하다
biotechnology	생명공학
vital	생명의, 생명에 관한, 생명유지에 필요한, 살아 있는
biology	생물학
productivity	생산성
produce	생산하다, 산출하다, 생기게 하다,
reproduce	생식(번식)하다
birthday	생일
ecosystem	생태계
inherent	생태의
ecology	생태학
clerk	서기
cool	서늘한
stand	서다
hurry	서두르다
hasten	서두르다
interact	서로 작용하다
document	서류
frost	서리
signature	서명
subscribe	서명승락하다
description	서술
pear	서양배
lyric	서정시
west	서쪽
coal	석탄
mix	섞다
line	선
election	선거
elect	선거하다
gift	선물
shelf	선반
cabin	선실
declare	선언하다
option	선택(권의 자유)
sermon	설교
preach	설교하다
persuasive	설득력 있는
eloquent	설득력 있는, 웅변력 있는
persuade	설득하다
found	설립하다.
explanation	설명
explain	설명하다
illustrate	설명하다
account	설명하다 계산
install	설치하다
sugar	설탕
island	섬
serve	섬기다
fiber	섬유
fibre	섬유
sex	성
anger	성
castle	성
gender	성
succeed	성공하다
offend	성나게 하다
match	성냥
statement	성명(진술)서
ingredient	성분
compound	성분 등을 혼합하다
bible	성서, 성경
adult	성인
grow	성장하다
priest	성직자
achieve	성취하다
world	세계
germ	세균
tax	세금
heritage	세습 재산
detergent	세제
laundry	세탁물
countless	셀수없는
cattle	소
salt	소금
shower	소나기 빗발치듯 퍼붓다(쏟다)
pine	소나무 수척해 지다
girl	소녀
boy	소년
noise	소리
sound	소리
still	소리가 없는 아직(도)
cry	소리치다
retail	소매
sleeve	소매
rumor	소문
rumour	소문
naive	소박한
spend	소비하다
consume	소비하다
revive	소생하다
novel	소설
suit	소송
client	소송의뢰인
minority	소수
few	소수의
belonging	소유물, 소속
possess	소유하다
cherish	소중히 하다
aptitude	소질
parcel	소포
picnic	소풍
excursion	소풍
software	소프트웨어
digest	소화시키다
speed	속도
whisper	속삭이다
attribute	속성
in	-속에
cheat	속이다
belong	속하다
hand	손
finger	손가락 손가락을 대다
guest	손님
watch	손목시계
palm	손바닥
slap	손바닥으로 때리다
junior	손아래사람
hold	손에 갖고 있다
handle	손잡이
tag	손잡이가죽
nail	손톱
damage	손해
brush	솔
initiative	솔선, 독창성
frank	솔직한
frankly	솔직히
craft	솜씨
remit	송금하다, 면제하다
bunch	송이
iron	쇠
beef	쇠고기
decay	쇠퇴하다
bloom	쇳덩이
number	수
several	수개의
nun	수녀 집비둘기의 일종
means	수단, 방법
allowance	수당
metropolitan	수도권(의)
faucet	수도꼭지
monastery	수도원
passive	수동적인
receipt	수령
watermelon	수박
monk	수사
repair	수선(수정)하다
transport	수송(운송)하다
riddle	수수께끼
tuition	수업료
mustache	수염
capacity	수용력, 능력
accommodate	수용하다
capital	수위의
prime	수위의, 최초의, 원시적인
veterinarian	수의사
income	수입
import	수입하다
numerically	수적으로
crystal	수정
shy	수줍은
contraction	수축, 축소
export	수출하다 수출
vertical	수평면에 직각인, 수직의
level	수평의
mathematics	수학
suite	수행원
conduct	수행하다, 처리하다
baggage	수화물
crop	수확
harvest	수확
reap	수확하다
consider	숙고하다
deliberate	숙고하다
skill	숙련
expert	숙련가
fate	숙명
homework	숙제
moment	순간
cop	순경
order	순서
pure	순수한  깨끗한, 순전한, 결백한
cruise	순항하다
cycle	순환
circulation	순환
circulate	순환하다
patrol	순회
spoon	숟가락
conceal	숨기다
breathe	숨쉬다
worship	숭배
wood	숲
forest	숲
easy	쉬운
facility	쉬움
readily	쉽게, 기꺼이
facilitate	쉽게하다
skirt	스커어트
spectrum	스펙트럼
wise	슬기로운
sad	슬픈
sore	슬픈
teen	슬픔
assault	습격
habit	습관
custom	습관
habitual	습관적인
moisture	습기
wetland	습지
passenger	승객
consent	승낙하다
triumph	승리
victory	승리, 전승
crew	승무원
preferment	승진, 발탁
promote	승진시키다 진행시키다,
poem	시
visual	시각의, 물건을 보기 위한
hour	시간
period	시간
punctual	시간을 지키는
clock	시계
tick	시계소리
countryside	시골
rural	시골의
cottage	시골집
opportune	시기가 좋은, 알맞은
loud	시끄러운
burn	시내
creek	시내
stream	시내
era	시대
attempt	시도하다
cereal	시리얼,곡물
citizen	시민
civil	시민의
scan	시의 운율을살피다
verse	시의 한 줄, 시구  일련의 시구
poet	시인
approve	시인하다, 승인하다, 찬성하다
begin	시작하다
start	시작하다
commence	시작하다
initiate	시작하다
mayor	시장
tense	시제
consistent	시종일관한
sour	시큼한 시어지다 시큼한 것
let	시키다
exam	시험
test	시험
trial	시험
examine	시험하다
prove	시험하다, 실험하다, 경험하다, 시험해 보다
try	시험해보다
vegetable	식물  야채, 푸성귀, 남새, 채소
colony	식민지
discerning	식별력 있는, 안목 있는
meal	식사
edible	식용의
grocery	식품잡화류
god	신
nerve	신경
nervous	신경의
fuse	신관
conviction	신념
bridegroom	신랑
newspaper	신문
recruit	신병
bride	신부
status	신분
gentleman	신사
holy	신성한
sacred	신성한
faith	신용
trust	신용
credit	신용
identity	신원, 정체성
divine	신의
freshman	신입생
body	신체
myth	신화
thread	실
gym	실내체조장
gymnasium	실내체조장
instance	실례
disappoint	실망시키다
plant	실물
enforce	실시하다
real	실재하는
practical	실제의
substantial	실체의
confess	실토하다
failure	실패
fail	실패하다
execute	실행하다, 집행하다
experiment	실험
lab	실험실
laboratory	실험실
dislike	싫어하다, 혐오
public	심리, 심리 상태
psychology	심리학
errand	심부름
heart	심장
referee	심판
grief	심한 슬픔(deep sorrow)
cross	십자형
wrap	싸다
contend	싸우다
fight	싸움
bud	싹, 꽃 몽우리
rice	쌀
chilly	쌀쌀한
twin	쌍동이
both	쌍방의
pile	쌓아 올린 것
perishable	썩기 쉬운
rot	썩다
rotten	썩은
shoot	쏘다
expose	쐬다, 드러내다, 맞히다
use	쓰다
write	쓰다
litter	쓰레기, 어지르다
bitter	쓴
obsolete	쓸모없게 된
useless	쓸모없는
available	쓸모있는
sow	씨를 뿌리다
seed	씨앗
chew	씹다
wash	씻다
glue	아교
wife	아내
not	아니다
son	아들
down	아래로
below	아래에
under	-아래에
lower	아래의, 낮은, 낮추다
beauty	아름다움
maybe	아마
perhaps	아마
probably	아마, 십중팔구
conceivably	아마도, 상상컨데
nothing	아무것도 …없다
nowhere	아무데도 …없다
nobody	아무도 -않다 하찮은 사람
none	아무도(조금도)-않다 조금도(결코)-않다
however	아무리
father	아버지
dad	아빠
kid	아이
child	아이
uncle	아저씨
quite	아주
identical	아주 동일한
aunt	아주머니
yet	아직
flatter	아첨하다
morning	아침
breakfast	아침밥
vice	악덕,  비행, 타락 행위
demon	악마
devil	악마
nightmare	악몽
spite	악의
worsen	악화시키다
fog	안개
mist	안개
agenda	안건
guidance	안내
attendant	안내원, 참석자
goodbye	안녕히 가세요
ease	안락
disappear	안보이게 되다
into	-안으로
introduce	안으로 들이다
inner	안의(내적인)
safe	안전한
secure	안전한
stable	안정된
inside	안쪽
sit	앉다
egg	알
aware	알고 있는
know	알다
allergic	알레르기의
inform	알리다
announce	알리다
communicate	알리다
acquaint	알리다, 익히다, 숙지하다
pill	알약
cancer	암
memorize	암기하다.
recite	암송하다
suggest	암시하다
overwhelm	압도하다
pressure	압력, 
stress	압박
squeeze	압착하다
before	앞에
forth	앞으로
previous	앞의, 이전의
forward	앞쪽에
patriot	애국자
caterpillar	애벌레
pet	애완동물
affection	애정
berry	액과
accent	액센트
liquid	액체
baseball	야구
wildlife	야생동물
wild	야생의
brute	야수 짐승같은
ambition	야심
medicine	약
somewhat	약간
slight	약간의
promise	약속, 서약, 계약
appointment	약속, 임명
engage	약속하다
drug	약제
predator	약탈자
weak	약한
bully	약한 자를 못살게 구는 자
weaken	약화시키다.
thin	얇은
slice	얇은조각
deal	양
sheep	양
quantity	양
spice	양념
compatible	양립할 수 있는
wool	양모
conscience	양심
upkeep	양육, 유지
nurture	양육하다
brew	양조하다
shallow	얕은 얕은 곳 얕아지다
unexpected	얘기치 않은
shoulder	어깨
shrug	어깨를 어쓱하다
which	어느 쪽
either	어느 하나의
alternative	어느 한쪽의 양자택일
dark	어두운
dim	어둑한
where	어디에 (-하는)곳에 pr.어디 (문제의)장소
any	어떤
how	어떻게
somehow	어떻게 해서든지,
ridiculous	어리석은
silly	어리석은 바보
lamb	어린 양
approximate	어림셈의
estimate	어림잡다
mother	어머니
parent	어버이
awkward	어색한
yesterday	어제
dizzy	어지러운
vocabulary	어휘, 용어수, 용어 범위
detain	억류하다
depress	억압하다
curb	억제하다
rein	억제하다
control	억제하다
compel	억지로 -시키다
hill	언덕, 낮은 산 인도 고지
journalist	언론인
language	언어
when	언제
get	얻다
gain	얻다
obtain	얻다
acquire	얻다
face	얼굴
handsome	얼굴(자태)이 잘생긴
feature	얼굴의 생김새
freeze	얼다
zebra	얼룩말
soon	얼마 안 가서
some	얼만가의
ice	얼음
sternly	엄격하게
rigorous	엄격한, 혹독한
solemn	엄숙한
stingently	엄중하게
strict	엄중한
thumb	엄지손가락 엄지손가락으로 만지다
dispensable	없어도 되는
hip	엉덩이
spill	엎지르다
about	-에 대하여
precede	-에 앞서다
per	-에 의하여
despite	-에도 불구하고 모욕
at	-에서
enclose	에워싸다
surround	에워싸다
engine	엔진
filter	여과기 여과하다
passport	여권
here	여기에
hello	여보
spare	여분의
female	여성
queen	여왕
afford	여유가 있다
inn	여인숙
sister	여자형제
trip	여행
voyage	여행
journey	여행
itinerary	여행 일정표
travel	여행하다
reverse	역
station	역
disgusting	역겨운
foul	역겨운, 반칙
coach	역마차
history	역사
historic	역사상 중요한
paradox	역설
nonetheless	역시
year	연
yearbook	연감
research	연구
smoke	연기
age	연령
fuel	연료
federal	연방의
pink	연분홍색
senior	연상의
associate	연상하다, 관련시키다
speech	연설
series	연속
sequence	연속
consecutive	연속의, 연이은
drill	연습
practice	연습
practise	연습
coast	연안
kit	연장통
concert	연주회
pencil	연필 연필로 쓰다
banquet	연회
heat	열
rank	열
fever	열
open	열다
tropical	열대의
inferior	열등한
passionate	열렬한
aspire	열망하다
key	열쇠
eager	열심인
enthusiastic	열심인
zeal	열의
addict	열중하게 하다
goat	염소
overhear	엿듣다
inspire	영감을 주다
glory	영광
permanent	영구의
clever	영리한
nutrition	영양분
nourish	영양분을 주다
hero	영웅
eternal	영원한
forever	영원히
domain	영토
territory	영토
influence	영향력
affect	영향을 주다
movie	영화
cinema	영화관
profile	옆 얼굴, 반면상 인물 소개  태도, 자세
yes	예
foretell	예견하다
deposit	예금
precaution	예방책
preliminary	예비의, 사전 준비
pretty	예쁜, 귀여운, 참 한, 조촐한
budget	예산
forecast	예상
anticipate	예상하다
art	예술
artistic	예술의, 예술적인
predict	예언하다, 예보하다 예언하다
exception	예외
courtesy	예의범절
ancient	옛날의
nowadays	오늘날에는, 요즈음에는
tonight	오늘밤에 오늘밤
today	오늘은
come	오다
hut	오두막
audition	오디션
entertainment	오락, 대접
arrogant	오만한
thrill	오싹하다 오싹함
contaminate	오염시키다
A.M.	오전
motorcycle	오토바이
misunderstand	오해하다.
P.M.	오후
afternoon	오후
rather	오히려
prefer	오히려 …을 좋아하다,
temperature	온도
thermometer	온도계
gentle	온화한
mild	온후한
rise	올리다
raise	올리다
olive	올리브나무
just	올바른
right	올바른
shift	옮기다
remove	옮기다
transfer	옮기다
justify	옳다고 하다
correct	옳은
as	-와 같은 정도로
stubborn	완고한
complete	완성하다
perfect	완전한
thorough	완전한
flush	왈칵흐르다
king	왕
crown	왕관
throne	왕위(에 오르다)
royal	왕의
prince	왕자, 태자, 세자, 대군
dynasty	왕조
why	왜
because	왜냐하면
surgery	외과
surgeon	외과의사
apparently	외관상으로는, 분명히
diplomat	외교관
abroad	외국으로
alien	외국의
exotic	외국의
foreign	외국의
appearance	외무, 출현
external	외부의
shout	외치다
exclaim	외치다
outgoing	외향적인
left	왼쪽의
claim	요구하다
demand	요구하다
require	요구하다
fee	요금
fare	요금
charge	요금
cradle	요람
restaurant	요리점
cook	요리하다 요리사
factor	요소
element	요소
summary	요약
simmarize	요약하다.
bathroom	욕실
brave	용감한
courage	용기
encourage	용기를 돋우다
courageous	용기있는
strategy	용병학
forgive	용서하다
pardon	용서하다 용서
chief	우두머리
captain	우두머리(chief)
we	우리가
umbrella	우산
priority	우선순위
dominant	우세한
excellent	우수한
elegant	우아한
graceful	우아한
chance	우연
casual	우연한
haphazardly	우연히, 무턱대고, 되는 대로
depression	우울증
depressed	우울한
gloomy	우울한, 어두운
cosmos	우주
universe	우주
astronaut	우주비행사
spacecraft	우주선
mail	우편물
luck	운
fortune	운
motion	운동
workout	운동
exercise	운동
movement	운동,움직임
athlete	운동가
athletic	운동선수
doom	운명
destiny	운명
vehicle	운반 기구, 운송 수단,  수레, 차량, 탈것
drive	운전하다
fortunate	운좋은
canal	운하
weep	울다
mobile	움직이기 쉬운
move	움직이다
operate	움직이다
grin	웃다
puddle	웅덩이
circle	원
telecommunication	원격통신
perspective	원근법의 원근 화법
material	원료
principle	원리, 원칙, 법칙, 공리
text	원문
cone	원뿔
monkey	원숭이
primitive	원시의, 초기의
cause	원인
causal	원인의
atom	원자
atomic	원자의
source	원천
month	월
stomach	위
crisis	위기
grand	위대한
up	위로
upward	위로 향한
upwards	위로 향한
violate	위반하다
satellite	위성
comfort	위안
dignity	위엄
on	위에
committee	위원회
commission	위임
over	위쪽
upper	위쪽의
position	위치
commit	위탁하다
committable	위탁할 수 있는
behalf	위함
danger	위험
hazard	위험
risk	위험 걸다
endanger	위험에 빠뜨리다.
save	위험에서 구하다
hazardous	위험한
scare	위협하다
cow	위협하다 암소
buzz	윙윙거리는 소리
regret	유감
van	유개트럭
organism	유기체 (생물)
organic	유기체의
fluid	유동성의
ghost	유령
glass	유리
advantage	유리한 입장
promising	유망한
famous	유명한
nanny	유모
nurse	유모
similar	유사한
abort	유산하다
infant	유아
humor	유우머
unique	유일무이한
only	유일한
sole	유일한 발바닥
remains	유적
gene	유전(인)자
genetic	유전의
convict	유죄로 판결하다 죄수
fluent	유창한
kindergarten	유치원
cheerful	유쾌한
current	유행의
fashionable	유행하는
prevalent	유행하는, 널리 퍼진
genre	유형
tempt	유혹하다
valid	유효한
army	육군
massive	육중한
outline	윤곽
ethic	윤리
rate	율
rhythm	율동
seem	-으로 보이다
consist	-으로 이루어지다
roar	으르렁거리다 으르렁소리
silver	은
grace	은총
galaxy	은하
pollute	-을 더럽히다
along	-을 따라
meet	-을 만나다
utilise	-을 이용하다
utilize	-을 이용하다
except	-을 제외하고는 제외하다
ensure	-을 책임지다
beverage	음료
plot	음모
intrigue	음모
food	음식
feed	음식(먹이)을 주다
cater	음식물을 마련하다
music	음악
tone	음조
town	읍
stare	응시하다
beside	-의 곁에
alongside	-의 곁에
underlie	-의 밑에 있다
beneath	-의 바로 아래에
between	-의 사이에 사이에
upon	-의 위에
opinion	의견
counsel	의논
intention	의도
duty	의무
obligate	의무를 지우다
compulsory	의무적인
mean	의미하다
physician	의사
ritual	의식, 의례
conscious	의식적인
doubt	의심
suspicion	의심
undoubtedly	의심 할 바 없는
suspicious	의심하는
chair	의장
chairman	의장
will	의지
medical	의학의
intent	의향
assembly	의회
parliament	의회
this	이
tooth	이
become	-이 되다
win	이기다
overcome	이기다
prevail	이기다, 극복하다, 압도하다 우세하다, 보급되다
selfish	이기적인
lead	이끌다
guide	이끌다
derive	이끌어 내다
moss	이끼
be	-이다
since	-이래
such	이러한
thus	이렇게
theory	이론
accomplish	이루다
attain	이르다
early	이른
name	이름
forehead	이마
already	이미
ideal	이상
curious	이상스러운
strange	이상한
extraordinary	이상한
reason	이성
dew	이슬
transplant	이식하다
tale	이야기
speak	이야기하다
relate	이야기하다
narrate	이야기하다
neighbor	이웃사람(나라)
neighbour	이웃사람(나라)
joint	이음매
benefit	이익
profit	이익, 이득, 벌이
ago	이전에
ever	이전에
formerly	이전에, 예전에
former	이전의
prior	이전의, 앞의
immigration	이주, 이민
migrate	이주하다
immigrate	이주하다
comprehensive	이해력있는
considerate	이해심 많은
comprehend	이해하다
understand	이해하다
fulfil	이행하다
fulfill	이행하다
divorce	이혼
accustomed	익숙한
ripe	익은
mature	익은
human	인간의
character	인격
artifact	인공유물
artificial	인공의
respirator	인공호흡장치
population	인구
popularity	인기, 대중성
patience	인내심
patient	인내심이 강한 환자
deliver	인도하다
mankind	인류
humanity	인류, 인간성
greet	인사하다
impress	인상지우다
print	인쇄하다, 프린트하다
quote	인용하다
cite	인용하다(quote)
personnel	인원
seal	인장
concede	인정하다
recognize	인정하다
acknowledge	인정하다
race	인종
racial	인종(상)의
ethnic	인종의
whether	-인지 어떤지
inflation	인플레이션
doll	인형
job	일
task	일
work	일
affair	일
journal	일간신문
diary	일기
annual	일년의
generation	일대
list	일람표
general	일반적인
generalize	일반화하다
portion	일부, 부분
temporary	일시적인
occur	일어나다
definite	일정한
tour	일주
occupation	일직업
coincidence	일치
conform	일치시키다
accord	일치하다
coincide	일치하다
correspond	일치하다
disagree	일치하지 않다
earn	일하여 벌다
disposable	일회용의
read	읽다
lose	잃다
loss	잃음
wage	임금
lease	임대차
office	임무
super	임시고용배우
tentatively	임시로
interim	임시의
pregnant	임신한 충만한
though	-임에도 불구하고 그러나
mouth	입
wear	입다
lip	입술
particle	입자
admission	입장
connect	잇다 이어지다
present	있는, 존재하는
likely	있을 법한
forget	잊다
leaf	잎
qualify	자격을 부여하다
entitle	자격을 주다
tiny	자그마한
incentive	자극적인
stimulate	자극하다
self	자기
own	자기자신의 소유하다
automatic	자동의
car	자동차
automobile	자동차 자동차의
boast	자랑하다
vain	자만심강한, 헛된
lock	자물쇠
voluntary	자발적인, 수의의
mercy	자비
charity	자비
asset	자산
suicide	자살 자살하다
autobiography	자서전
magnet	자석
pose	자세, 포즈  마음가짐  꾸민 태도
descendent	자손
nature	자연
resource	자원
freedom	자유
liberty	자유
free	자유로운
liberal	자유주의의
bicycle	자전거 자전거를 타다
continent	자제심이 있는
pride	자존심
often	자주
haunt	자주가다
purple	자줏빛의  새빨간  제왕의
vanish	자취를 감추다
farewell	작별
little	작은
path	작은 길
cell	작은 방
small	작은 작은 부분 적게
bit	작은 조각
minor	작은 편의
lawn	잔디밭
cruel	잔인한
well	잘
shred	잘게 자르다, 찢다
error	잘못
mislead	잘못믿게하다
wake	잠깨다
asleep	잠들은
submarine	잠수함
sleep	잠자다
grip	잡기
take	잡다
chat	잡담
strain	잡아당기다
magazine	잡지
weed	잡초 잡초를 뽑다
spin	잣다
master	장
glove	장갑
minister	장관
ministry	장관(목사)의 직(소임)
spectacular	장관의
mischief	장난, 해악
toy	장난감 장난하다
magnificent	장대한
superb	장려한
scene	장면
barrier	장벽
equipment	장비
funeral	장사
spot	장소
place	장소
situation	장소
local	장소의
decorate	장식하다
obstacle	장애(물)
merit	장점
scholarship	장학금
ash	재
measure	재다
stuff	재료
timber	재목
amuse	재미나게 하다
reoccurrence	재발
recur	재발하다
prompt	재빠른, 신속한, 즉시 …하는
wealth	재산
property	재산, 자산
recycle	재생 이용하다
finance	재정
review	재조사
talent	재주
witty	재치 있는
sneeze	재치기 하다
smart	재치있는
reunification	재통일
judge	재판관
tray	쟁반
that	저
evening	저녁
eve	저녁, 밤
supper	저녁식사
dine	저녁식사를 하다
author	저자
storage	저장
curse	저주
beyond	저편에
resist	저항하다
enemy	적
suitable	적당한
appropriate	적당한
equator	적도
adapt	적용시키다
specialize	전공하다
bulb	전구
biography	전기
romantic	전기소설적인
electric	전기의
overnight	전날밤의
trophy	전리품
outlook	전망
prospect	전망, 조망, 경치
patent	전매특허권 전매특허의
ahead	전방에
turnover	전복
legend	전설
tradition	전설
telegraph	전신
electronic	전자(학)의
war	전쟁
utter	전적인
battery	전지
whole	전체의
entire	전체의
conventional	전통적인,재래식의
battle	전투
altogether	전혀
typical	전형적인
telephone	전화
distract	전환시키다
bow	절
absolute	절대의
desperate	절망적인
despair	절망하다
cliff	절벽
thrift	절약
economy	절약
moderation	절제
moderate	절제하는
young	젊은
youth	젊음
dot	점
point	점
lunch	점심
occupancy	점유, 선점
decent	점잖은
gradual	점차적인
adhesive	점착성의
access	접근
dish	접시
contact	접촉
exquisite	정교한, 더없이 훌륭한
subscription	정기구독(료)
airline	정기항공
vigorous	정력적인, 강건한, 활기 있는, 격렬한
front	정면
opposite	정반대의 (것), 
conquer	정복하다
government	정부
square	정사각형의
top	정상
sentiment	정서
spirit	정신
spiritual	정신, 흑인 영가
passion	정열
noon	정오
cube	정육면체
butcher	정육점주인
justice	정의
define	정의하다
refine	정제정련하다
honesty	정직
honest	정직한
dinner	정찬
policy	정책
politics	정치
routine	정해진 일
exact	정확한
precise	정확한
accurate	정확한
precisely	정확히, 꼼꼼하게
adjourn	정회하다
milk	젖
eliminate	제거하다
tender	제공
empire	제국
imperial	제국의
drawer	제도사
lot	제비
constraint	제약, 제한
propose	제의하다, 제출하다 추천하다, 지명하다
fabrication	제작
manufacture	제조하다
restrain	제지하다
restrict	제한하다
sculpt	조각 조각하다
sculpture	조각 조각하다
carve	조각하다
condition	조건
mock	조롱하다
recipe	조리법
coherent	조리있는
investigate	조사하다
statue	조상
ancestor	조상
tide	조수
caution	조심
cautious	조심성 있는, 신중한
treaty	조약
quiet	조용한
silent	조용한
encounter	조우
manipulation	조작
system	조직
tissue	조직
organise	조직하다
organize	조직하다
symptom	조짐
even	-조차
nephew	조카
niece	조카딸
item	조항
clause	조항
provision	조항, 공급
harmonious	조화로운
refer	조회시키다
respect	존경하다
presence	존재, 현존, 실재  출석, 임석, 참석
exist	존재하다
narrow	좁은
track	좁은 길, 추적하다
lane	좁은길
bell	종
species	종
religion	종교
sort	종류
dependence	종속
paper	종이
file	종이끼우개
terminal	종점의
tribe	종족
university	종합대학(교) 대학의(에 관계 있는)
fond	좋아하는
like	좋아하다
good	좋은
seat	좌석
depend	좌우되다
criminal	죄의
guilty	죄지은
week	주
county	주
province	주, 성, 도  범위, 영역, 분야
subjective	주관의
orchestrate	주관하다, 조정하다
bishop	주교
give	주다
confer	주다
fold	주름
wrinkle	주름
weekend	주말 주말의 주말을 지내다
fist	주먹
punch	주먹질, 펀치  힘, 활기
remarkable	주목할 만한
regard	주목해서 보다
inject	주사하다
tin	주석
main	주요한
principal	주요한, 주된, 제일의, 앞장서는
attention	주의
attentive	주의 깊은, 경청하는
host	주인, 집주인 노릇, 호스트
insist	주장하다
hesitate	주저하다
kettle	주전자
die	죽다
perish	죽다, 사라지다
dead	죽은
mortal	죽을운명의
death	죽음
kill	죽이다
preparation	준비
ready	준비가 된
prepare	준비하 다, 마련하다, 채비를 갖추다
provide	준비하다, 미리 …에 대비하다  규정하다
compliance	준수
row	줄
range	줄
stem	줄기
stock	줄기
trunk	줄기
stripe	줄무늬
striped	줄무늬의
shrink	줄어들다
reduce	줄이다
lessen	줄이다, 완화하다
alleviate	줄이다, 완화하다
medium	중간
halfway	중간의
intermediate	중간의 중간물
gravity	중력
neutral	중립의
medieval	중세(풍)의
among	-중에
important	중요한
significant	중요한
critical	중요한, 위기의
mediate	중재하다
pause	중지
rat	쥐
trouser	즈봉
namely	즉
instant	즉시의
fun	즐거운 생각
joy	즐거움
pleasure	즐거움
entertain	즐겁게 하다
delight	즐겁게하다 즐거워하다
enjoy	즐기다
evidence	증거
steam	증기
proof	증명
certificate	증명서, 자격정, 자격증을 교부하다
certify	증명하다
testify	증명하다
demonstrate	증명하다
witness	증언
donate	증여하다
perceive	지각하다
earth	지구
district	지구
globe	지구, 구
now	지금
due	지급기일이 된
pass	지나가다
intelligence	지능
rent	지대
map	지도
direct	지도하다
tedious	지루한
boredom	지루함
diameter	지름
shortcut	지름길
geography	지리
region	지방
municipality	지방자치단체
dominate	지배하다
pay	지불하다
owe	지불할 의무가 있다
roof	지붕
consistently	지속적으로
hell	지옥
eraser	지우는 사람
applicant	지원자
candidate	지원자
degrade	지위를 낮추다
messy	지저분한
intelligent	지적인
intellectual	지적인
indicate	지적하다
designated	지정된
appoint	지정하다
geology	지질학
expense	지출
guideline	지침
gaze	지켜보다
support	지탱하다
horizon	지평선
subway	지하도
conductor	지휘자, 전도체
mechanic	직공
confront	직면하다
business	직업
profession	직업 공언, 선언, 고백
immediate	직접의
vacuum	진공
diagnose	진단
truth	진리
launch	진수시키다
true	진실
sincere	진실한
cordially	진심으로
serious	진지한
genuine	진짜의
authentic	진짜의
ongoing	진행 중인
procedure	진행, 경과 절차
process	진행, 작용
progress	진행, 전진, 진척  진보, 향상, 발달, 발전
evolution	진화
evolve	진화하다
mud	진흙
quality	질
inquiry	질문, 문의
questionnaire	질문표
choke	질식시키다
trail	질질 끌다
envy	질투
jealous	질투심많은
load	짐
wagon	짐마차
beast	짐승
discharge	짐을부리다
suspect	짐작하다
house	집
group	집단
intensive	집중적인
concentrate	집중하다
rabbit	집토끼
executive	집행의
build	짓다
bark	짖다
dense	짙은
straw	짚
weave	짜다
clap	짝짝
short	짧은
sock	짧은 양말
split	쪼개다
side	쪽
toward	-쪽으로
towards	-쪽으로
chase	쫓다
follow	쫓다
pursue	쫓다, 추적하다, 몰다
distort	찌그러뜨리다
sting	찌르다
tea	차
windshield	차 앞 유리
chill	차가움
garage	차고
discrepancy	차이, 불일치
tenant	차지인
occupy	차지하다
color	착색하다
lapse	착오, 실수
vote	찬부 표시, 투표, 표결
cupboard	찬장
crack	찰싹 소리내다 금가다 날카로운소리
clay	찰흙
participate	참가하다
oak	참나무
tolerate	참다
indeed	참으로
spear	창
window	창
warehouse	창고
pale	창백한
creation	창조
creature	창조물
creative	창조적인
create	창조하다
seek	찾다
search	찾다
channel	채널, 경로
vegetarian	채식주의자
adopt	채용하다
whip	채찍 채찍질하다
book	책
volume	책  권
trick	책략
blame	책망하다
desk	책상
responsible	책임을 져야할
virgin	처녀, 동정녀, 미혼 여성, 동정녀 마리아
transact	처리하다
liquidate	처분하다, 청산하다
initial	처음의
cloth	천
fabric	천
thousand	천
millennium	천년
astronomy	천문학
angel	천사
ceiling	천장
genius	천재
disaster	천재
vocation	천직, 사명 직업, 생업, 장사  적성, 소질, 재능
wire	철사
spell	철자하다
philosophy	철학
high-tech	첨단 과학 기술의
cutting-edge	첨단의
primary	첫째의, 제1위의, 수위의 초등의, 초보의
clean	청결한
adolescent	청년기의
jeans	청바지
blueprint	청사진
juvenile	청소년의
sweep	청소하다
audience	청중
auditorium	청중
beg	청하다
checked	체크무늬의
arrest	체포하다
draft	초고
excess	초과
invite	초대하다
incur	초래하다, 발생시키다
green	초록색
novice	초보자
portrait	초상
focus	초점
meadow	초지
gun	총
sum	총계
total	총계 전체의 합계하다
gross	총계의
supreme	최고의
maximum	최고점
recent	최근의
utmost	최대의
minimum	최소 한도
minimal	최소(한도)의
final	최후의
ultimate	최후의
add	추가하다
infer	추론하다
scandal	추문
abstract	추상적인
cold	추운
reference	추천서
nominate	추천하다
recommend	추천하다
guess	추측(짐작)하다
ugly	추한
soccer	축구
football	축구
bless	축복하다
abbreviate	축약하다, 단축하다
accumulate	축적하다
feast	축제
festive	축제의
wet	축축한
damp	축축한 습기 적시다
congratulate	축하하다
exit	출구
departure	출발
depart	출발하다
birth	출생
attend	출석하다
of	출신의
entrance	출입구
advert	출현
impact	충격
monitor	충고자
advise	충고하다
bump	충돌 부딪치다
clash	충돌하다
collide	충돌하다
enough	충분한
sufficient	충분한
adequate	충분한, 적절한
loyal	충성스러운
hobby	취미
cancel	취소하다
aisle	측면복도
layer	층
story	층
dentist	치과의사
beat	치다
knock	치다
strike	치다
cure	치료
remedy	치료
therapy	치료법
fatal	치명적인
deadly	치명적인
soar	치솟다
dimension	치수
bias	치우침
friend	친구
intimate	친밀한
kind	친절한
relative	친척
autograph	친필,서명
familiar	친한
bed	침대
couch	침대
aggressive	침략적인
bedroom	침실 성적인
spit	침을 뱉다
invade	침입하다
praise	칭찬
compliment	칭찬
curry	카레요리 카레로 맛을 내다
sword	칼
collar	칼라
great	커다란
curtain	커어튼
nose	코
elephant	코끼리
sniff	코를 킁킁거리다
cope	코우프(성직자의 긴 겉옷)
bean	콩
cookie	쿠키
chef	쿡
size	크기
cricket	크리켓
big	큰
large	큰
bough	큰 가지
aloud	큰 소리로
blunder	큰 실수
fiasco	큰 실수, 대실패
major	큰쪽의
club	클럽
tall	키큰
giggle	킥킥웃다
native	타고난
glow	타다
ride	타다
corrupt	타락한
oval	타원형(의)
compromise	타협 타협하다
carbohydrate	탄수화물
bullet	탄환
greed	탐욕
expedition	탐험
explore	탐험하다
tower	탑
attitude	태도
fetus	태아
sun	태양
solar	태양의
cab	택시
tunnel	터널
jaw	턱
chin	턱(끝) 턱에 대다
beard	턱수염
hair	털
table	테이블
tape	테이프
debate	토론 토론하다
discuss	토론하다
estate	토지
vomit	토하다
pat	톡톡 가볍게 치다
gear	톱니바퀴
statistics	통계(학)
statistic	통계의 통계량
notify	통고하다
commute	통근하다
log	통나무
currency	통용
notice	통지, 통보
insight	통찰(력)
integrate	통합하다
passage	통행, 통과
retire	퇴직하다
input	투입
invest	투자하다
conflict	투쟁
poll	투표
splash	튀기다
flip	튀기다 홱 움직이다 튀기기
privilege	특권, 특전, 특별 취급
special	특별한
peculiar	특별한
trait	특성
corps	특수부대, 단체
particular	특수한
characteristic	특유한
specific	특정한
especially	특히
mistake	틀리다
leisure	틈
corn	티눈
delegate	파견하다
destruction	파괴
destroy	파괴하다
dig	파다
ruin	파멸
crisp	파삭파삭한
bankrupt	파산자
burst	파열하다
debris	파편
plate	판
copyright	판권
judgement	판단, 심판
pool	판돈
sale	판매
panel	판벽널
arm	팔
elbow	팔꿈치
sell	팔다
pop	팝
defeat	패배
scoop	퍼내다, 국자
flutter	퍼덕거리다
pump	펌프스   댄스용 구두
pub	펍
expand	펴다
spread	펴다
prejudice	편견, 선입관
conveniently	편리하게
convenient	편리한
letter	편지
edit	편집하다
compile	편찬하다
flat	편평한
evaluate	평가하다
assess	평가하다, 감정하다
average	평균
equality	평등
usual	평소의
calm	평온한
reputation	평판
parallel	평행의
peace	평화
junk	폐물고물, 내버리다
overall	포괄(전면)적인 덧옷
grape	포도
poster	포스터
embrace	포옹하다
mammal	포유류
pavement	포장도로
pocket	포켓
include	포함하다
comprise	포함하다
wide	폭넓은
riot	폭동, 소요, 소동   야단법석, 다채로움,
violence	폭력
explode	폭발시키다
bomb	폭탄 폭격하다
explosion	폭팔
storm	폭풍
pole	폴란드사람
mark	표
surface	표면
bleach	표백하다
title	표제
caption	표제
norm	표준
standard	표준
normal	표준(의)
represent	표현(묘사)하다
expressive	표현하는
blue	푸른
undone	푼, 마치지 않은
grass	풀밭
loose	풀어진
graze	풀을 먹다
landscape	풍경
abundant	풍부한
freelancer	프리렌서
blood	피
defendant	피고 피고의
shelter	피난처
feedback	피드백
tire	피로하게 하다
tyre	피로하게 하다
bleed	피를 흘리다
skin	피부
superficial	피상적인
avoid	피하다
inevitable	피할 수 없는
pin	핀 핀으로 꽂다
necessity	필수품
need	필요
necessary	필요한
pretend	핑계삼다
one	하나(의)
unify	하나로 하다
a	하나의
sky	하늘
heaven	하늘
do	하다
destined	하도록 운명 지워진
sewage	하수 오물
unless	-하지 않으면
yawn	하품(하다)
lesson	학과
school	학교
semester	학기
study	학문
student	학생
academy	학술원
graduate	학위를 수여하다
scholar	학자
gang	한 떼
stitch	한 바늘
span	한 뼘
couple	한 쌍
piece	한 조각
midst	한가운데
idle	한가한
pace	한걸음
uniform	한결같은
limit	한계
once	한번
stroke	한번치기
middle	한복판의
sigh	한숨
pair	한쌍
finite	한정되어 있는
able	할 수 있는
capable	할 수 있는
can	할 수 있다
intend	-할 작정이다
assign	할당하다
allocate	할당하다
grandfather	할아버지
discount	할인
premium	할증금,  액면 초과액, 프리미엄
scratch	할퀴다, 할퀴어 상처 를 내다  긁다
with	함께
imply	함축하다
incorporate	합동시키다
rational	합리적인
reasonable	합리적인
legitimate	합법의
merge	합병하다
complex	합성물
chorus	합창
aircraft	항공기
harbor	항구
harbour	항구
port	항구, 항만, 상항
harm	해
solve	해결하다
navy	해군(력)
solution	해법,해답,용액
disperse	해산시키다, 분산시키다
interpret	해석하다
beach	해안
must	-해야 한다
oversea	해외(로부터)의
overseas	해외(로부터)의
cable	해저전신
injure	해치다
core	핵심
nuclear	핵의, 핵을 형성하는 원자핵의
behavior	행동
behaviour	행동
act	행동하다
behave	행동하다
welfare	행복
planet	행성
happy	행운의
deed	행위
scent	향기
enhance	향상하다
homesick	향수병의
permit	허가하다
chore	허드렛일, 
allow	허락하다
permissible	허용되는, 허용할 수 있는
nonsense	허튼 소리
constitution	헌법, 체질
dedication	헌신
baggy	헐렁한
barn	헛간
wander	헤매다
swim	헤엄치다
helicopter	헬리콥터
tongue	혀
revolution	혁명
cash	현금 현금으로 바꾸다 현금의
modern	현대의
contemporary	현대의
microscope	현미경
phenomenon	현상
banner	현수막
reality	현실
actual	현실의
realistic	현실적인, 사실적인
cooperate	협동하다
threat	협박
association	협회, 관련
type	형
formation	형성
formal	형식상의
brother	형제
comet	혜성
severe	호된
tiger	호랑이
slim	호리호리한
lake	호수
escort	호위하다
favor	호의
favour	호의
gorgeous	호화로운
or	혹은
soul	혼
chaos	혼돈
mess	혼란
turmoil	혼란, 소란
confuse	혼란시키다
wedding	혼례
lone	혼자의
congestion	혼잡, 막힘
congest	혼잡하게 하다
mixture	혼합물
blend	혼합하다
publicity	홍보, 주목
flood	홍수
provoke	화나게 하다
freight	화물
volcano	화산
arrow	화살
fossil	화석
make-up	화장, 구성
toilet	화장실
restroom	화장실
cosmetic	화장품
coin	화폐
chemistry	화학
chemical	화학의
reconciliation	화해
reconcile	화해시키다
admantly	확고하게
steady	확고한
amplify	확대하다
establish	확립하다
microphone	확성기
convince	확신시키다
certain	확신하는
confident	확신하는
sure	확신하는, 확실한 , 틀림없는
verify	확인하다
confirm	확인하다
environment	환경
circumstance	환경
refund	환불하다
fantasy	환상, 공상영화
fantastic	환상적인
illusion	환영
welcome	환영 환영받는
lively	활기찬
activate	활동적으로 하다
active	활동적인,적극적인
yellow	황색의 황색
bull	황소
wilderness	황야
fascinate	황홀케 하다
accountant	회계사
hall	회관
corporation	회사, 법인
grey	회색의
retrieve	회수하다
affiliate	회원으로 가입시키다
council	회의
congress	회의
conference	회의
minutes	회의록, 의사록
switch	회초리
conversation	회화
acquisition	획득
effective	효과적인
burden	후렴
after	후에
sponsor	후원자
retreat	후퇴
discipline	훈련
fine	훌륭한
steal	훔치다
interrupt	훼방놓다
stir	휘젓다
whistle	휘파람
vacation	휴가
rest	휴식
holiday	휴일
marvelous	휼륭한
imitate	흉내내다
simulate	흉내내다
fierce	흉포한
flow	흐르다
swing	흔들리다
shake	흔들어 움직이다
pupil	흔히 국민학교 중학교 학생
glance	흘긋 봄
glimpse	흘끗 봄
shed	흘리다
soil	흙
absorb	흡수하다
interest	흥미
intriguing	흥미를 자아내는
excitement	흥분
excite	흥분시키다
rare	희귀한
comedy	희극
hope	희망
helpless	희망 없는, 가능성 없는
sparsely	희박하게, 드문드문
sacrifice	희생
victim	희생, 산 제물, 인신 제물
casualty	희생자
white	흰
force	힘
might	힘
power	힘
